palabra	fuente
a	Internet
ab	Internet
ac	Internet
ad	Internet
adhic	Internet
aliqui	Internet
aliquis	Internet
alius	manual
alter	manual
an	Internet
ante	Internet
apud	Internet
at	Internet
atque	Internet
aut	Internet
autem	Internet
cum	Internet
cur	Internet
de	Internet
deinde	Internet
dum	Internet
e	Internet
ego	Internet
enim	Internet
erant	Internet
erat	Internet
ergo	Internet
es	Internet
est	Internet
et	Internet
etiam	Internet
etsi	Internet
ex	Internet
fio	Internet
haec	Internet
haud	Internet
hic	Internet
hoc	Internet
iam	Internet
idem	Internet
igitur	Internet
ille	Internet
in	Internet
infra	Internet
inter	Internet
interim	Internet
ipse	Internet
is	Internet
ita	Internet
magis	Internet
me	Internet
modo	Internet
mox	Internet
multus	manual
nam	Internet
ne	Internet
nec	Internet
necque	Internet
neque	Internet
nisi	Internet
non	Internet
nos	Internet
noster	manual
o	Internet
ob	Internet
omnis	Internet
per	Internet
possum	Internet
post	Internet
pro	Internet
qua	Internet
quae	Internet
quam	Internet
quare	Internet
qui	Internet
quia	Internet
quibus	Internet
quicumque	Internet
quidem	Internet
quilibet	Internet
quis	Internet
quisnam	Internet
quisquam	Internet
quisque	Internet
quisquis	Internet
quo	Internet
quod	Internet
quoniam	Internet
re	Internet
rebus	Internet
rem	Internet
res	Internet
se	manual
sed	Internet
si	Internet
sic	Internet
sive	Internet
sub	Internet
sui	Internet
sum	Internet
sunt	Internet
super	Internet
suus	Internet
tam	Internet
tamen	Internet
tandem	Internet
te	Internet
trans	Internet
tu	Internet
tum	Internet
ubi	Internet
uel	Internet
uero	Internet
unus	Internet
ut	Internet
vel	Internet
vester	manual
res	manual
rem	manual
rei	manual
rebus	manual
rerum	manual
nvtr	tragedias
quid	tragedias
mihi	tragedias
nunc	tragedias
tibi	tragedias
ner	tragedias
ph	tragedias
med	tragedias
clyt	tragedias
quicquid	tragedias
quem	tragedias
hinc	tragedias
nulla	tragedias
oed	tragedias
licet	tragedias
regna	tragedias
sen	tragedias
lyc	tragedias
hyl	tragedias
pyrrh	tragedias
amph	tragedias
ias	tragedias
thes	tragedias
atr	tragedias
el	tragedias
meg	tragedias
cr	tragedias
aeg	tragedias
oct	tragedias
thy	tragedias
andr	tragedias
vlix	tragedias
alcm	tragedias
ioc	tragedias
evr	tragedias
nvt	tragedias
nvnt	tragedias
quasi	republica
quidam	republica
que	manual
magnus	manual
summus	manual
sol	republica
annus	republica
pars	republica
animus	republica
causa	republica